......##......##...........
......##......##...........
..##..##......##..##..##...
..##..##......##..##..##...
..##..........##..######...
..##.......................
......##...................
@@@@@@@@@@@@@@@@@@@@@@##@@.
@@@@@@@@@@@@@@@@@@@@@@##@@.
###########################
............##########.....
......@............###.....
......@.....######.........
......@##########..........
......@........######......
......@####################
###########################
..................@........
.......########...@........
..................@........
..#####......#######...@...
....#######......####......
#########........##########
...........####............
...........#..#............
...........#..#............
